0,0,0,0,0,0,0,0,0,0,0,0,0,0,0,0,0,0,0,0,0,0,0,0,0,0
0,0,0,0,1,1,1,1,1,1,1,1,1,1,1,1,1,1,1,1,1,1,0,0,0,0
0,0,0,0,1,2,2,2,2,2,2,2,2,2,2,2,2,2,2,2,2,1,0,0,0,0
0,0,0,0,1,2,2,2,2,2,2,4,2,2,2,2,2,2,4,2,2,1,0,0,0,0
0,0,0,0,1,2,2,2,2,2,2,2,2,2,9,2,2,2,2,2,2,1,0,0,0,0
0,0,0,0,1,9,2,2,2,2,2,2,2,2,2,2,2,2,2,2,2,1,0,0,0,0
0,0,0,0,1,2,2,2,2,2,2,2,2,2,2,2,2,2,2,2,2,1,0,0,0,0
0,0,0,0,1,4,2,2,2,2,4,2,2,2,2,2,2,2,2,9,2,1,0,0,0,0
0,0,0,0,1,2,2,2,2,2,2,2,2,9,2,2,2,2,2,2,2,1,0,0,0,0
0,0,0,0,1,2,2,2,2,3,1,2,2,2,2,2,2,2,2,2,2,1,0,0,0,0
0,0,0,0,1,2,2,2,2,2,2,2,2,2,2,2,2,2,1,2,2,1,0,0,0,0
0,0,0,0,1,8,8,8,8,8,8,8,8,8,8,8,8,8,8,8,8,1,0,0,0,0
0,0,0,0,1,1,1,1,1,1,1,1,1,1,1,1,1,1,1,1,1,1,0,0,0,0
0,0,0,0,1,1,1,1,1,1,1,1,1,1,1,1,1,1,1,1,1,1,0,0,0,0
0,0,0,0,1,1,1,1,1,1,1,1,1,1,1,1,1,1,1,1,1,1,0,0,0,0